=======================================
====*****==============================
====*****==============================
====*****==============**************==
====*****=====***======**************==
====*****=====***======================
==============***=======******=========
==============***=======******=========
========================******=========
=======================================
