86 88 90 120 80 75 70 121 255
87 93 125 85 45 30 35 124 255
91 130 80 50 32 27 22 125 255
135 85 65 44 15 12 10 12 255
98 70 50 20 5 0 5 10 255
86 88 90 120 80 75 70 12 255
87 93 125 85 45 65 35 11 255
91 130 80 50 32 27 22 13
255 135 85 65 44 15 0 5 0 255
